1011111111111111111111
1011100111001111001101
1000001100000011001101
1011111100100011001101
1000000000100000000001
1000001111111111001101
1000000000000000001101
1000001100110011001101
1111111111111111111111
