1000000000000000000001
1011001111001111001101
1011001100000011001101
1010001100100011001101
1011000000100000000101
1011001111111111001101
1011000000000000001101
1011001100110011001101
1000000000000000000001
