1111111111111111111111
1010111000101110000111
1000111010101110100111
1010000010100000100111
1011111110101110100111
1010000010101110100111
1011111010101110100111
1000000010000110100001
1111111111111111111111
